####################
#..................#
#..##..............#
#......##..........#
#..........##......#
#.................H#
####################